"a" = (/turf/space,/area/space)
"b" = (/turf/simulated/wall,/area/constructionsite)
"c" = (/turf/simulated/floor/tiled,/area/constructionsite)
"d" = (/obj/machinery/light{dir = 1},/turf/simulated/floor/tiled,/area/constructionsite)
"e" = (/obj/machinery/light{icon_state = "tube1"; dir = 8},/turf/simulated/floor/tiled,/area/constructionsite)
"f" = (/obj/machinery/light{icon_state = "tube1"; dir = 4},/turf/simulated/floor/tiled,/area/constructionsite)
"g" = (/obj/effect/landmark/start,/turf/simulated/floor/tiled,/area/constructionsite)
"h" = (/obj/structure/cable{d2 = 2; icon_state = "0-2"; pixel_y = 0},/obj/machinery/power/apc{dir = 8; name = "west bump"; pixel_x = -24},/turf/simulated/floor/tiled,/area/constructionsite)
"i" = (/obj/structure/cable{d1 = 1; d2 = 2; icon_state = "1-2"; pixel_y = 0},/turf/simulated/floor/tiled,/area/constructionsite)
"j" = (/obj/structure/cable,/obj/machinery/power/fractal_reactor,/turf/simulated/floor/tiled,/area/constructionsite)
"k" = (/obj/machinery/light,/turf/simulated/floor/tiled,/area/constructionsite)

(1,1,1) = {"
aaaaaaaaaaaaaaaaaaaaaaaaaaaaaaaa
aaaaaaaaaaaaaaaaaaaaaaaaaaaaaaaa
aaaaaaaaaaaaaaaaaaaaaaaaaaaaaaaa
aaaaaaaaaaaaaaaaaaaaaaaaaaaaaaaa
aaaaaaaaaaaaaaaaaaaaaaaaaaaaaaaa
aaaaaaaaaaaaaaaaaaaaaaaaaaaaaaaa
aaaaaaaaaaaaaaaaaaaaaaaaaaaaaaaa
aaaaaaaaaaaaaaaaaaaaaaaaaaaaaaaa
aaaaaaaaaaaaaaaaaaaaaaaaaaaaaaaa
aaaaaaaaabbbbbbbbbbbbbbbaaaaaaaa
aaaaaaaaabcccdcccccdcccbaaaaaaaa
aaaaaaaaabcccccccccccccbaaaaaaaa
aaaaaaaaabcccccccccccccbaaaaaaaa
aaaaaaaaabecccccccccccfbaaaaaaaa
aaaaaaaaabcccccccccccccbaaaaaaaa
aaaaaaaaabcccccccccccccbaaaaaaaa
aaaaaaaaabccccccgccccccbaaaaaaaa
aaaaaaaaabcccccccccccccbaaaaaaaa
aaaaaaaaabcccccccccccccbaaaaaaaa
aaaaaaaaabecccccccccccfbaaaaaaaa
aaaaaaaaabhccccccccccccbaaaaaaaa
aaaaaaaaabiccccccccccccbaaaaaaaa
aaaaaaaaabjcckccccckcccbaaaaaaaa
aaaaaaaaabbbbbbbbbbbbbbbaaaaaaaa
aaaaaaaaaaaaaaaaaaaaaaaaaaaaaaaa
aaaaaaaaaaaaaaaaaaaaaaaaaaaaaaaa
aaaaaaaaaaaaaaaaaaaaaaaaaaaaaaaa
aaaaaaaaaaaaaaaaaaaaaaaaaaaaaaaa
aaaaaaaaaaaaaaaaaaaaaaaaaaaaaaaa
aaaaaaaaaaaaaaaaaaaaaaaaaaaaaaaa
aaaaaaaaaaaaaaaaaaaaaaaaaaaaaaaa
aaaaaaaaaaaaaaaaaaaaaaaaaaaaaaaa
"}
